5 1 1 1 1 1 1 1 1 1
0 1 1 0 0 0 0 0 4 0
0 1 1 0 1 0 1 1 1 0
0 3 3 0 4 0 0 0 0 0
4 1 1 0 1 1 1 1 1 0
0 0 0 6 1 1 0 0 0 0
0 1 1 1 1 1 0 1 1 1
0 1 3 3 0 1 0 0 0 1
0 1 0 1 0 1 1 1 0 1
0 0 0 1 0 0 0 2 0 1
