0 1 1 1 1 1 1 1 1 1
0 1 1 0 0 0 4 0 0 0
0 1 1 0 1 0 1 0 1 0
0 3 3 0 4 0 0 0 4 5
0 1 1 0 1 1 1 1 1 0
0 0 0 0 1 1 6 0 4 4
0 1 1 1 1 1 2 1 1 1
0 1 0 0 0 1 0 0 0 1
0 1 0 1 0 1 1 1 0 1
0 0 0 1 0 0 0 0 0 1
